1111111111111111111111111111111111
1P0000000000000C00000C000000000001
1010010100100000101001000000010101
1010010010101010001001000000010101
1E1000000C00C0000000000000000000C1
1100111111111111111111101111111111
1001100000000000000000001111111111
1C11100111110111111111111111111111
100000100000100C00000C000000000001
1010010100100000101001000000010101
1010010010101010001001000000010101
100000000C00C0000000000000000001C1
1011111111011110001111111011111111
1011111111011111111111111001111111
100000000010000C00000C000100000001
1010010100100000101001000000010101
1010010010101010001001000000010101
100000000C00C0000000000000000000C1
1111111111111111111111111111111111