1111111111
1E1C0000P1
1111111111