1111111111111111
1C00000000C000P1
1011000111111001
1101110100001011
1101110100001011
1C000000000000E1
1111111111111111
