1111111111111111
1C00C00P00000001
1011000111111001
11C111C100001011
1101110100C01011
10000000000000E1
1111111111111111