1111111111111
10000P0E00001
1111111111111