1111111111111
10P00000000C1
1111111111111