1111111111111
10000C0E0C0C1
1111111111111