1111111111111111111111111111111111
1E0000000000000C00000C000000000001
1010010100100000101001000000010101
1010010010101010001001000000010101
1P0000000C00C0000000000000000000C1
1111111111011111111111111111111111
1111111111000111111111111111111111
100000000000000C00000C000000000001
1010010100100000101001000000010101
1010010010101010001001000000010101
100000000C00C0000000000000000000C1
1111111111111111111100111111111111
1111111111111111111110111111111111
100000000000000C00000C000000000001
1010010100100000101001000000010101
1010010011101010001001000000010101
100000001C001C000000000000000000C1
1111111111111111111111111111111111